w w w w w w w w w w w w w w w w w w w w
w k e w e e e e w f w e e e e e w e k w
w e e w e e e e w e w e e e e e w e e w
w e e e e e e e w g w e e e e e e e e w
w e e e e e w e w g w e e w e e e e e w
w e e e e k w g w g w e e w k e e e e w
w e e e w w w e e e e e e w w w e e e w
w e e e e e e e e e e e e e g e e e e w
w e e e e e e e e w e e e e w w w w w w
w w w w w w e e e w w w e e g g g e f w
w f e g g g e e w w w e e e w w w w w w
w w w w w w e e e e w e e e e e e e e w
w e e e e g e e e e e e e e e e e e e w
w e e e w w w e e e e e e w w w e e e w
w e e e e k w e e w g w g w k e e e e w
w e e e p e w e e w g w e w e e e e e w
w e e e e e e e e w g w e e e e e e e w
w e e w e e e e e w e w e e e e w e e w
w k e w e e e e e w f w e e e e w e k w
w w w w w w w w w w w w w w w w w w w w
