w w w w w w w w w w
w e g g e f g g e w
w e w w w w w w e w
w e p p p p p e e w
w e e e e e e w e w
w w e e p e e w e w
w e e e e e e w g w
w e w k w e w k k w
w e e e e e g k k w
w w w w w w w w w w
